#Central Asia
LIA = "countries/WesternLiao.txt"
LIU = "countries/Liu.txt"
SMR = "countries/Samarqand.txt"

#China
CHN = "countries/Chen.txt"
FAN = "countries/Fang.txt"
HAA = "countries/Han.txt"
HEE = "countries/He.txt"
HNN = "countries/Hunan.txt"
HON = "countries/Hongwu.txt"
LII = "countries/Li.txt"
LIN = "countries/Lin.txt"
QUA = "countries/Quanzhou.txt"
SNG = "countries/Song.txt"
XIA = "countries/Xia.txt"
YUU = "countries/Yu.txt"
ZHA = "countries/Zhang.txt"

#France
ANJ = "countries/Anjou.txt"
AQT	= "countries/Aquitania.txt"
BEA = "countries/Beauvais.txt"
BLS = "countries/Blois.txt"
BRL = "countries/Breteuil.txt"
LGS = "countries/Langres.txt"
MNE = "countries/Maine.txt"
MTI = "countries/Montiaur.txt"
NEM = "countries/Nemours.txt"
ONG = "countries/Orange.txt"
PRS = "countries/Paris.txt"
POU = "countries/Poitou.txt"
RET = "countries/Rethel.txt"
TOI = "countries/Touraine.txt"
VAS = "countries/Valois.txt" 

#Iberia
#RIB = "countries/Ribagorza.txt"
#URG = "countries/Urgell.txt"
#TRR = "countries/Tarragona.txt"
#BRC = "countries/Barcelona.txt"
#PRE = "countries/Pireneus.txt"
#ANA = "countries/Andorra.txt"
#ROU = "countries/Rousillion.txt"

#India
KFR = "countries/Kafurids.txt"

#Italy
ANC = "countries/Ancona.txt"
ABR = "countries/Abruzzo.txt"
API = "countries/Apulia.txt"	
AQL = "countries/D'Aquila.txt"
BTA = "countries/Bastia.txt"
BEL = "countries/Belluno.txt"
BEG = "countries/Bergamo.txt"
BRC = "countries/Brescia.txt"
FOG = "countries/Foggia.txt"
KLB = "countries/Kalbids.txt"
MSS = "countries/Massa.txt"
MNC = "countries/Monaco.txt"
RAV = "countries/Ravenna.txt"
SAN = "countries/SanMarino.txt"
TRO = "countries/Treviso.txt"

#Low Countries
NAM = "countries/Namur.txt"

#Middle East
SLJ = "countries/Seljuqids.txt"
AKG = "countries/Akgulids.txt"
HTM = "countries/Hetumids.txt"

#Russia
BJA = "countries/Bjarmaland.txt"
SCY = "countries/ScythoRus.txt"
KMK = "countries/Kalmykia.txt"
BEZ = "countries/Bezhetskaya.txt"
VLB = "countries/VolgaBulgaria.txt"

#South Germany
BSL = "countries/Basel.txt"
CMO = "countries/Como.txt"
